2;2;2;2;2;3;2;0;0;10;7;2
2;1;0;0;6;0;1;6;2;2;2;2
2;1;0;2;2;0;0;0;0;0;0;2
2;1;0;2;0;2;2;2;1;2;0;2
2;2;6;2;0;2;2;7;1;1;0;4
2;2;0;0;0;6;0;0;0;0;6;2
2;2;1;0;2;2;2;0;2;2;2;2
2;2;1;7;1;1;1;7;1;0;8;1
2;8;1;0;0;0;1;9;1;0;2;1
2;0;1;1;1;0;1;2;1;0;2;1
2;0;0;7;0;0;0;0;0;0;1;1
2;2;2;2;2;2;2;2;2;2;2;2