2;10;2;2;2;2;1;2;2;1;1;1
2;8;0;0;0;8;1;7;0;0;0;2
2;2;2;7;1;1;1;1;0;2;0;2
2;0;0;0;0;0;1;0;0;2;0;2
5;3;2;2;2;0;1;0;1;2;0;2
2;0;0;8;0;6;1;0;0;2;0;2
2;2;0;2;2;0;1;1;6;2;0;2
1;1;0;2;7;0;1;1;0;2;0;2
1;0;0;2;0;0;0;0;0;2;0;2
1;7;2;2;0;2;2;2;2;2;0;2
1;9;2;0;0;2;0;0;6;0;0;2
2;2;2;2;2;2;4;1;2;2;2;2