2;2;2;2;2;2;5;1;2;1;1;1
2;10;0;7;0;0;0;3;0;1;0;9
2;2;2;2;2;2;2;2;0;1;0;1
2;0;0;0;0;6;0;0;0;7;0;1
1;8;1;1;1;1;1;1;1;1;1;1
1;0;1;0;0;0;1;0;1;0;8;11
1;8;1;8;1;8;1;8;1;8;1;1
1;0;0;0;1;0;0;0;1;0;0;1
1;1;1;1;1;1;1;8;1;1;0;1
2;0;0;0;0;0;0;0;2;8;0;2
2;8;2;2;2;2;2;2;2;0;2;2
2;0;0;0;0;8;0;0;0;0;2;2